The all-too familiar quake of a nuclear detonation shocks you awake. As the commander of the last human warship, the Quarrelstar Galactic, it's up to you to get your crew and remaining fleet of human survivors safe from the onslaught of Skylon attacks.

Quarrelstar Galactic
An Interactive Fiction by Jason Spencer
Release 1 / Serial number 170209 / Inform 7 build 6M62 (I6/v6.33 lib 6/12N) SD

Captain's Quarters
Your cramped, bleak quarters. The lights flicker, revealing a disheveled bed, a messy desk with piles of paperwork, and a locker. To the East lies the Officer's Corridor.

>fuck me
That's not a verb I recognise.

>read paperwork
You see nothing special about paperwork.

>turn off lights
You can't see any such thing.

>look around
You can't see any such thing.

>make bed
That's not a verb I recognise.

>clean desk
You rub the desk.

>open locker
It seems to be locked.

>find key
That's not a verb I recognise.

>this is bs
That's not a verb I recognise.

>look for key
You can't see any such thing.

>get up
But you aren't in anything at the moment.

>look
Captain's Quarters
Your cramped, bleak quarters. The lights flicker, revealing a disheveled bed, a messy desk with piles of paperwork, and a locker. To the East lies the Officer's Corridor.

>look at desk
Bueureacracy has no place in a warzone. Stacks of official-looking paperwork drown the desk. There is a top drawer, bottom drawer, and cabinet attached to the desk.

>open top drawer
You open the top drawer.

>look in top drawer
The top drawer is empty.

>open bottom drawer
You open the bottom drawer.

>look in bottom drawer
The bottom drawer is empty.

>open cabinet
It seems to be locked.

>look at paperwork
After rummaging through the top third of your back-logged paperwork, you find a small bronze key.

>use key
That's not a verb I recognise.

>unlock cabinet
(with the small bronze key)
You unlock the cabinet.

>look in cabinet
You can't see inside, since the cabinet is closed.

>open cabinet
You open the cabinet, revealing a small metal key.

>open locker
It seems to be locked.

>take key
(the small metal key)
Taken.

>open locker
It seems to be locked.

>unlock locker
What do you want to unlock the locker with?

>with metal key
You can't see any such thing.

>unlock locker with metal key
You unlock the locker.

>open locker
You open the locker, revealing an uniform and a communicator.

>put on uniform
(first taking the uniform)
You put on the uniform.

>take communicator
Taken.

>use communicator
That's not a verb I recognise.

>look
Captain's Quarters
Your cramped, bleak quarters. The lights flicker, revealing a disheveled bed, a messy desk with piles of paperwork, and a locker. To the East lies the Officer's Corridor.

>go east
Officer's Corridor
A gray, metallic corridor. To the West lies the Captain's Quarters, and to the east lies the Command Center.

>look around
You can't see any such thing.

>look
Officer's Corridor
A gray, metallic corridor. To the West lies the Captain's Quarters, and to the east lies the Command Center.

>go east
Command Center
You enter the grand Command Center, an octagonal room with ampitheater-style command stations. In the middle lies your station, a great table-like console and many large screens, collectively enough to cover a football field.

It's far too quiet for a time of crisis. In fact, there is no trace of any of your crew anywhere. Damage from the Skylon nuke must have blocked off all entrances to the Command Center except yours. At least, that's what you'd like to think.

>juimp
That's not a verb I recognise.

>jump
You jump on the spot.

* * *

The all-too familiar quake of a nuclear detonation shocks you awake. As the commander of the last human warship, the Quarrelstar Galactic, it's up to you to get your crew and remaining fleet of human survivors safe from the onslaught of Skylon attacks.

Quarrelstar Galactic
An Interactive Fiction by Jason Spencer
Release 1 / Serial number 170209 / Inform 7 build 6M62 (I6/v6.33 lib 6/12N) SD

Captain's Quarters
Your cramped, bleak quarters. The lights flicker, revealing a disheveled bed, a messy desk with piles of paperwork, and a locker. To the East lies the Officer's Corridor.

>go east
Officer's Corridor
A gray, metallic corridor. To the West lies the Captain's Quarters, and to the east lies the Command Center.

>go east
Command Center
You enter the grand Command Center, an octagonal room with ampitheater-style command stations. In the middle lies your station, a great table-like console and many large screens, collectively enough to cover a football field.

It's far too quiet for a time of crisis. In fact, there is no trace of any of your crew anywhere. Damage from the Skylon nuke must have blocked off all entrances to the Command Center except yours. At least, that's what you'd like to think.

>take Command Console
That's fixed in place.

>use communicator
That's not a verb I recognise.

>use
That's not a verb I recognise.

* * *

The all-too familiar quake of a nuclear detonation shocks you awake. As the commander of the last human warship, the Quarrelstar Galactic, it's up to you to get your crew and remaining fleet of human survivors safe from the onslaught of Skylon attacks.

Quarrelstar Galactic
An Interactive Fiction by Jason Spencer
Release 1 / Serial number 170209 / Inform 7 build 6M62 (I6/v6.33 lib 6/12N) SD

Captain's Quarters
Your cramped, bleak quarters. The lights flicker, revealing a disheveled bed, a messy desk with piles of paperwork, and a locker. To the East lies the Officer's Corridor.

>use book
That's not a verb I recognise.

>using
That's not a verb I recognise.

>use
That's not a verb I recognise.

* * *

The all-too familiar quake of a nuclear detonation shocks you awake. As the commander of the last human warship, the Quarrelstar Galactic, it's up to you to get your crew and remaining fleet of human survivors safe from the onslaught of Skylon attacks.

Quarrelstar Galactic
An Interactive Fiction by Jason Spencer
Release 1 / Serial number 170209 / Inform 7 build 6M62 (I6/v6.33 lib 6/12N) SD

Captain's Quarters
Your cramped, bleak quarters. The lights flicker, revealing a disheveled bed, a messy desk with piles of paperwork, and a locker. To the East lies the Officer's Corridor.

>use
What do you want to use?

>use but
You can't see any such thing.

* * *

>look at paperwork
After rummaging through the top third of your back-logged paperwork, you find a small bronze key.

>unlock cabinet
(with the small bronze key)
You unlock the cabinet.

>open cabinet
You open the cabinet, revealing a small metal key.

>take key
(the small metal key)
Taken.

>unlock locker
What do you want to unlock the locker with?

>unlock locker with small metal key
You unlock the locker.

>open locker
You open the locker, revealing an uniform and a communicator.

* * *

The all-too familiar quake of a nuclear detonation shocks you awake. As the commander of the last human warship, the Quarrelstar Galactic, it's up to you to get your crew and remaining fleet of human survivors safe from the onslaught of Skylon attacks.

Quarrelstar Galactic
An Interactive Fiction by Jason Spencer
Release 1 / Serial number 170209 / Inform 7 build 6M62 (I6/v6.33 lib 6/12N) SD

Captain's Quarters
Your cramped, bleak quarters. The lights flicker, revealing a disheveled bed, a messy desk with piles of paperwork, and a locker. To the East lies the Officer's Corridor.

>look through paperwork
After rummaging through the top third of your back-logged paperwork, you find a small bronze key.

>take small bronze key
You already have that.

>unlock cabinet
(with the small bronze key)
You unlock the cabinet.

* * *

>open cabinet
You open the cabinet, revealing a small metal key.

>take metal key
Taken.

>unlock locker with metal key
You unlock the locker.

* * *

>open locker
You open the locker, revealing an uniform and a communicator.

>take uniform
Taken.

>wear uniform
You put on the uniform.

>take communicator
Taken.

>wear communicator
You put on the communicator.

>go east
Officer's Corridor
A gray, metallic corridor. To the West lies the Captain's Quarters, and to the east lies the Command Center.

* * *

>go east
Command Center
You enter the grand Command Center, an octagonal room with ampitheater-style command stations. In the middle lies your station, a great table-like console and many large screens, collectively enough to cover a football field.

It's far too quiet for a time of crisis. In fact, there is no trace of any of your crew anywhere. Damage from the Skylon nuke must have blocked off all entrances to the Command Center except yours. At least, that's what you'd like to think.

>use communicator
HI

>look at communicator
You see nothing special about the communicator.

* * *

>look through paperwork
After rummaging through the top third of your back-logged paperwork, you find a small bronze key.

>unlock cabinet
(with the small bronze key)
You unlock the cabinet.

>take key
You already have that.

>unlock locker
(with the small bronze key)
That doesn't seem to fit the lock.

>open cabinet
You open the cabinet, revealing a small metal key.

>take small metal key
Taken.

>unlock locker with metal key
You unlock the locker.

>look in locker
You can't see inside, since the locker is closed.

>open locker
You open the locker, revealing an uniform and a communicator.

>don uniform
(first taking the uniform)
You put on the uniform.

>don communicator
(first taking the communicator)
You put on the communicator.

>look at uniform
A boxy, ill-fitted jacket and trousers, a melancholy grey color. A pair of small insignias of your rank glinted from your collar, the only adornments that had been deemed acceptable in these lean times.

>look at communicator
An older headset-style communicator. Great for communicating with the rest of the fleet, but you need to be in the Command Center in order to use it.

>go east
Officer's Corridor
A gray, metallic corridor. To the West lies the Captain's Quarters, and to the east lies the Command Center.

* * *

>go east
Command Center
You enter the grand Command Center, an octagonal room with ampitheater-style command stations. In the middle lies your station, a great table-like console and many large screens, collectively enough to cover a football field.

It's far too quiet for a time of crisis. In fact, there is no trace of any of your crew anywhere. Damage from the Skylon nuke must have blocked off all entrances to the Command Center except yours. At least, that's what you'd like to think.

>use communicator
Greetings, Commander. Here is the current sitrep:
We currently are in contact with 0/50 civilian ships. You are able to jump at any time, just please ensure that you plot your jump first.

>push button
Which do you mean, the Jump button or Plot button?

>push FTL Jump button
You can't see any such thing.

>push the FTL Jump button
You can't see any such thing.

>push Jump button
Nothing obvious happens.

>push Plot button
Nothing obvious happens.

* * *

>take key
(the small metal key)
Taken.

>open locker with metal key
You unlock the locker.

>open locker
You open the locker, revealing an uniform and a communicator.